10
9
01081212121212121212
02071010101010091212
03060103030303081212
03050217030315071010
01030316031314060111
02030303030303050211
11030303030303111111
11030303030303111111
11030303030303031511
